171:1
30:2
116:1
97:1
110:1
176:1
9:1
150:3
191:1
167:1
127:1
96:1
84:1
40:1
103:1
11:1
119:1
156:1
155:1
12:1
21:1
107:1
2:1
120:1
86:2
143:1
197:1
14:1
