150:3
176:1
156:1
11:1
191:1
12:1
171:1
116:1
21:1
97:1
110:1
103:1
30:2
84:1
14:1
119:1
120:1
167:1
96:1
197:1
127:1
2:1
107:1
9:1
40:1
155:1
143:1
86:2
