14:1
30:2
167:1
197:1
107:1
176:1
9:1
103:1
86:2
97:1
96:1
11:1
150:3
120:1
191:1
40:1
84:1
2:1
143:1
110:1
156:1
12:1
155:1
171:1
21:1
119:1
116:1
127:1
