143:1
103:1
11:1
84:1
127:1
14:1
86:2
155:1
167:1
191:1
156:1
197:1
110:1
150:3
119:1
107:1
30:2
176:1
116:1
2:1
97:1
40:1
21:1
12:1
9:1
171:1
96:1
120:1
