119:1
156:1
97:1
107:1
197:1
171:1
12:1
110:1
30:2
116:1
40:1
96:1
84:1
11:1
86:2
14:1
191:1
21:1
127:1
9:1
155:1
143:1
2:1
167:1
176:1
103:1
120:1
150:3
