12:1
110:1
167:1
40:1
2:1
84:1
116:1
150:3
156:1
14:1
127:1
155:1
86:2
96:1
9:1
103:1
97:1
119:1
107:1
21:1
176:1
191:1
197:1
143:1
11:1
30:2
120:1
171:1
