170:6
140:1
186:1
188:1
57:1
8:1
139:1
102:1
108:1
176:5
84:1
77:1
192:1
149:1
86:2
82:3
