102:1
192:1
170:6
139:1
140:1
77:1
82:3
176:5
8:1
108:1
57:1
84:1
149:1
188:1
186:1
86:2
