139:1
186:1
170:6
57:1
8:1
140:1
188:1
108:1
82:3
77:1
149:1
176:5
192:1
102:1
86:2
84:1
