108:1
188:1
140:1
139:1
84:1
57:1
77:1
176:5
149:1
82:3
8:1
102:1
86:2
192:1
186:1
170:6
