30:2
119:1
96:1
167:1
21:1
11:1
171:1
9:1
120:1
97:1
127:1
191:1
155:1
107:1
2:1
116:1
40:1
110:1
156:1
176:1
12:1
86:2
197:1
150:3
103:1
143:1
84:1
14:1
